===== Outer Symbol Table =====
boolean	_type_	constant	_boolean_
integer	_type_	constant	_integer_
real	_type_	constant	_real_
false	_boolean_	constant	_false_
true	_boolean_	constant	_true_
paramcount	_function_
program	_program_

===== Function Symbol Table =====
paramcount	_integer_	return

===== Program Symbol Table =====
a	_integer_
b	_integer_
ret	_integer_
max	_function_

===== Function Symbol Table =====
max	_integer_	return
num1	_integer_	param
num2	_integer_	param
result	_integer_